{
  "key": "kernel_panic",
  "label": "KernelPanic",
  "width": 14,
  "height": 12,
  "spawn": [1, 6],
  "boss_spawn": [11, 6],
  "exit": [12, 1],
  "tiles": [
    "##############",
    "#............E",
    "#............#",
    "#...........x#",
    "#............#",
    "#............#",
    "#............#",
    "#............#",
    "#x...........#",
    "#............#",
    "#............#",
    "##############"
  ]
}
