{
  "key": "the_leak",
  "label": "TheLeak",
  "width": 16,
  "height": 12,
  "spawn": [1, 6],
  "boss_spawn": [13, 6],
  "exit": [14, 1],
  "tiles": [
    "################",
    "#..............E",
    "#..............#",
    "#..............#",
    "#..............#",
    "#..............#",
    "#..............#",
    "#..............#",
    "#..............#",
    "#..............#",
    "#..............#",
    "################"
  ]
}
